1.224363580743933755e-01
1.225612268963317958e-01
1.107994563653517811e-01
1.011652334416107968e-01
1.081649346490974467e-01
1.069483104010816865e-01
8.820489988685918659e-02
7.884286581151489504e-02
