9.883045729481795827e-02
1.194297520785061462e-01
1.154266246461898571e-01
1.269124584193224159e-01
1.205523377234916788e-01
1.264366713929615527e-01
1.083363576355524105e-01
9.848438919118290835e-02
